X                       X
X                       X
X                       X
X      S              XXX
X    XXXXKKKKK  X P   XEX
X               X     X X
X               X     X X
X               X       X
X  P            XXXXXXXUX
XXXXXXXXXXXXXXUU   