X                       X
X                       X
X                       X
XS        PP           EX
XXXXXXXXXXXXXXXXXXXXXXXXX