X                       X
X                       X
X                       X
XS                     EX
XXXXXXXXXXXXXXXXXXXXXXXXX