X                       X
X                       X
X                       X
X      S        P   E   X
X    XXXXKKKKKXXXXXXXXXXX
X                       X
X                       X
X                       X
X       PP             EX
XXXXXXXXXXXXXXBBKKKXXXXXX