X                          X
X                          X
X  XXXXXXXXXXXXXXXXXXXXXXX X
X               K        X X

                K
                K
                K
                K
                K
                K
                K
                K
                K
                K  
X   S                    X X
XRXXXXBKK       KKXXXXXXXX X
XR              BB          X
XR            BB           X
X          BB      X  P   X
X         P    P   X     X
X      P           X    X
X                  X    X
X                  X    X
X                  X    X
X                  KEEEEX
XUUXXXXXXXXXXXXXXXXX
KKKK 