X                       X
X                       X
XS  XXXXXXXXXXXXXXXXX   X
XXXRX                   K
XXXUX   XXXXXXXXXXXXXXXXX
X  K    K               X
X                       X
X                       X
X               K    P  X
X               K P     X
X               K       X
X               X     X X
X               X  E    X
X               XXXXXXXUX
XXXXXXXXXXUUUUUUUUUX
XKXXXXXXXXXXXXXXXXXX 