X                       X
X                       X
X                       X
X      S            E   X
X    XXXXKKKKKXXXXXXXXXXX
X                       X
X                       X
X                       X
X                      EX
XXXXXXXXXXXXXXBBKKKXXXXXX