X                          X
X                          X
X  XXXXXXXXXXXXXXXXXXXXXXX X
X                        X X
                K

                K
                K
                K
                K
                K
                K
                K
                K
                K  
X   S           K        X X
XRXXXXBKK       KXXXXXXXXX X
XR              BB          X
XR            BB           X
X          BB      X      X
X                  X     X
X              P   X    X
X              P   X    X
X              P   X    X
X                  X    X
X                  KEEEEX
XUUXXXXXXXXXXXXXXXXX
KKK 