X                       X
X                       X
XS  XXXXXXXXXXXXXXXXX   X
XXXRX                   K
XXXUX         XXXXXXXXXXX
XKKKK                   X
X                       X
X                  X    X
X                  X    X
X                  X    X
X                  X    X
X                  X    X
X                  X    X
X                  KEEEEX
XUUUUUUUUUUUUUUUUUUX 
XKXXXXXXXXXXXXXXXXXX