X                       X
X                       X
X                       X
X      S              XXX
X    XXXXKKKKK  X     XEX
X               X     X X
X               X     X X
X               X       X
X               XXXXXXXUX
XXXXXXXXXXXXXXUU   