X                       X
X                       X
X                 X     X
X      S          X     X
X   XXXXXXXXXXXXX X     X
X   RX          X       X
X   RX          X       X
X   RX          X     XEX
X   RX          XKKKKKXXX
XUUUXX 
KKKKKKBBKKKXXXXXX