X                       X
X                       X
XS  XXXXXXXXXXXXXXXXX   X
XXXRX                   K
XXXUX    XXXXXXXXXXXXXXXX
X                       X
X                       X
X               P  X    X
X               P  X    X
X               P  X    X
X               P  X    X
X                  X    X
X                  X    X
X                  KEEEEX
XUUUUUUUUUUUUUUUUUUX
XKXXXXXXXXXXXXXXXXXX