X                       X
X                       X
X                       X
XS                     EX
XXXXXXXXXXB   XXXXXXXXXXX